"","id1","id2","n","n_behave","n_scan","actor.obs","subject.obs","ave.obs","frequency"
"1","6814","7234",3,1,2,12,28.3333333333333,20.1666666666667,0.148760330578512
"2","6814","7255",6,2,4,12,33.6666666666667,22.8333333333333,0.262773722627737
"3","6814","7265",1,1,0,12,16.1666666666667,14.0833333333333,0.0710059171597633
"4","6814","7328",1,1,0,12,46.5,29.25,0.0341880341880342
"5","6814","7391",2,1,1,12,25.8333333333333,18.9166666666667,0.105726872246696
"6","6818","7246",5,5,0,NA,50.5,NA,NA
"7","6818","7298",1,1,0,NA,47.8333333333333,NA,NA
"8","6818","7324",13,13,0,NA,48.8333333333333,NA,NA
"9","6818","7427",1,1,0,NA,49.5,NA,NA
"10","6818","7448",3,3,0,NA,23.6666666666667,NA,NA
"11","6818","7461",1,1,0,NA,29.6666666666667,NA,NA
"12","6833","7218",12,7,5,22.5,28.6666666666667,25.5833333333333,0.469055374592834
"13","6833","7219",3,1,2,22.5,38.3333333333333,30.4166666666667,0.0986301369863014
"14","6833","7232",8,3,5,22.5,25.6666666666667,24.0833333333333,0.332179930795848
"15","6833","7263",2,1,1,22.5,50.8333333333333,36.6666666666667,0.0545454545454545
"16","6833","7443",4,2,2,22.5,18.1666666666667,20.3333333333333,0.19672131147541
"17","6833","7477",1,1,0,22.5,4.66666666666667,13.5833333333333,0.0736196319018405
"18","6879","7271",1,1,0,13,17,15,0.0666666666666667
"19","6879","7314",4,1,3,13,11.6666666666667,12.3333333333333,0.324324324324324
"20","6888","6879",2,1,1,11.5,13,12.25,0.163265306122449
"21","6888","7218",1,1,0,11.5,28.6666666666667,20.0833333333333,0.0497925311203319
"22","6888","7314",5,3,2,11.5,11.6666666666667,11.5833333333333,0.431654676258993
"23","6888","7340",1,1,0,11.5,11,11.25,0.0888888888888889
"24","6888","7366",2,1,1,11.5,7.5,9.5,0.210526315789474
"25","6905","7234",1,1,0,1.16666666666667,28.3333333333333,14.75,0.0677966101694915
"26","6937","7083",3,2,1,20.3333333333333,27.3333333333333,23.8333333333333,0.125874125874126
"27","7010","",1,1,0,44.5,NA,NA,NA
"28","7010","7072",12,9,3,44.5,29.5,37,0.324324324324324
"29","7010","7186",1,1,0,44.5,29.3333333333333,36.9166666666667,0.0270880361173815
"30","7010","7207",17,6,11,44.5,45.6666666666667,45.0833333333333,0.377079482439926
"31","7010","7222",4,3,1,44.5,16.5,30.5,0.131147540983607
"32","7010","7230",4,1,3,44.5,16.5,30.5,0.131147540983607
"33","7010","7234",1,1,0,44.5,28.3333333333333,36.4166666666667,0.0274599542334096
"34","7010","7267",15,8,7,44.5,35.5,40,0.375
"35","7010","7298",1,1,0,44.5,47.8333333333333,46.1666666666667,0.0216606498194946
"36","7010","7315",1,1,0,44.5,28,36.25,0.0275862068965517
"37","7010","7328",2,2,0,44.5,46.5,45.5,0.043956043956044
"38","7010","7453",1,1,0,44.5,34.3333333333333,39.4166666666667,0.0253699788583509
"39","7010","7460",8,2,6,44.5,22.3333333333333,33.4166666666667,0.239401496259352
"40","7010","7472",5,2,3,44.5,33,38.75,0.129032258064516
"41","7038","6888",1,1,0,26.8333333333333,11.5,19.1666666666667,0.0521739130434783
"42","7038","7218",1,1,0,26.8333333333333,28.6666666666667,27.75,0.036036036036036
"43","7038","7271",2,1,1,26.8333333333333,17,21.9166666666667,0.091254752851711
"44","7038","7274",9,2,7,26.8333333333333,13.5,20.1666666666667,0.446280991735537
"45","7038","7280",4,4,0,26.8333333333333,15.3333333333333,21.0833333333333,0.189723320158103
"46","7038","7295",1,1,0,26.8333333333333,29.8333333333333,28.3333333333333,0.0352941176470588
"47","7038","7334",12,7,5,26.8333333333333,28,27.4166666666667,0.437689969604863
"48","7038","7339",7,1,6,26.8333333333333,22.8333333333333,24.8333333333333,0.281879194630873
"49","7038","7369",6,2,4,26.8333333333333,23.6666666666667,25.25,0.237623762376238
"50","7040","7139",9,2,7,39.5,36.6666666666667,38.0833333333333,0.236323851203501
"51","7040","7339",1,1,0,39.5,22.8333333333333,31.1666666666667,0.0320855614973262
"52","7040","7386",13,2,11,39.5,41,40.25,0.322981366459627
"53","7040","7390",9,2,7,39.5,45,42.25,0.21301775147929
"54","7040","7410",18,6,12,39.5,41.6666666666667,40.5833333333333,0.4435318275154
"55","7040","7426",4,2,2,39.5,41.3333333333333,40.4166666666667,0.0989690721649484
"56","7040","7480",14,4,10,39.5,42.6666666666667,41.0833333333333,0.340770791075051
"57","7040","7485",9,1,8,39.5,20.8333333333333,30.1666666666667,0.298342541436464
"58","7055","7214",1,1,0,2.16666666666667,1.66666666666667,1.91666666666667,0.521739130434783
"59","7055","7221",3,1,2,2.16666666666667,4.83333333333333,3.5,0.857142857142857
"60","7055","7477",2,1,1,2.16666666666667,4.66666666666667,3.41666666666667,0.585365853658537
"61","7055","7482",2,1,1,2.16666666666667,1.83333333333333,2,1
"62","7065","7304",1,1,0,1.5,1.66666666666667,1.58333333333333,0.631578947368421
"63","7065","7474",1,1,0,1.5,1.16666666666667,1.33333333333333,0.75
"64","7072","7010",9,4,5,29.5,44.5,37,0.243243243243243
"65","7072","7207",8,4,4,29.5,45.6666666666667,37.5833333333333,0.212860310421286
"66","7072","7234",3,3,0,29.5,28.3333333333333,28.9166666666667,0.103746397694524
"67","7072","7255",1,1,0,29.5,33.6666666666667,31.5833333333333,0.0316622691292876
"68","7072","7267",8,2,6,29.5,35.5,32.5,0.246153846153846
"69","7072","7328",9,5,4,29.5,46.5,38,0.236842105263158
"70","7072","7391",1,1,0,29.5,25.8333333333333,27.6666666666667,0.036144578313253
"71","7072","7460",8,5,3,29.5,22.3333333333333,25.9166666666667,0.308681672025723
"72","7072","7462",1,1,0,29.5,13.1666666666667,21.3333333333333,0.046875
"73","7072","7472",1,1,0,29.5,33,31.25,0.032
"74","7083","6937",6,3,3,27.3333333333333,20.3333333333333,23.8333333333333,0.251748251748252
"75","7083","7194",1,1,0,27.3333333333333,38,32.6666666666667,0.0306122448979592
"76","7083","7424",4,2,2,27.3333333333333,32.1666666666667,29.75,0.134453781512605
"77","7083","7475",10,5,5,27.3333333333333,27.1666666666667,27.25,0.36697247706422
"78","7139","7040",8,1,7,36.6666666666667,39.5,38.0833333333333,0.210065645514223
"79","7139","7386",12,7,5,36.6666666666667,41,38.8333333333333,0.309012875536481
"80","7139","7390",15,6,9,36.6666666666667,45,40.8333333333333,0.36734693877551
"81","7139","7410",15,6,9,36.6666666666667,41.6666666666667,39.1666666666667,0.382978723404255
"82","7139","7477",1,1,0,36.6666666666667,4.66666666666667,20.6666666666667,0.0483870967741936
"83","7139","7480",9,2,7,36.6666666666667,42.6666666666667,39.6666666666667,0.226890756302521
"84","7139","7485",17,3,14,36.6666666666667,20.8333333333333,28.75,0.591304347826087
"85","7186","7010",3,3,0,29.3333333333333,44.5,36.9166666666667,0.0812641083521445
"86","7186","7220",4,3,1,29.3333333333333,31.8333333333333,30.5833333333333,0.130790190735695
"87","7186","7227",3,3,0,29.3333333333333,18,23.6666666666667,0.126760563380282
"88","7186","7230",1,1,0,29.3333333333333,16.5,22.9166666666667,0.0436363636363636
"89","7186","7253",7,2,5,29.3333333333333,27.1666666666667,28.25,0.247787610619469
"90","7186","7290",3,2,1,29.3333333333333,8.33333333333333,18.8333333333333,0.15929203539823
"91","7186","7342",1,1,0,29.3333333333333,28.5,28.9166666666667,0.0345821325648415
"92","7186","7456",4,1,3,29.3333333333333,13.3333333333333,21.3333333333333,0.1875
"93","7186","7472",3,2,1,29.3333333333333,33,31.1666666666667,0.0962566844919786
"94","7190","7270",4,3,1,32.5,30.3333333333333,31.4166666666667,0.127320954907162
"95","7190","7302",5,1,4,32.5,39,35.75,0.13986013986014
"96","7190","7345",9,5,4,32.5,30.5,31.5,0.285714285714286
"97","7190","7367",2,1,1,32.5,16,24.25,0.0824742268041237
"98","7190","7407",6,5,1,32.5,31.3333333333333,31.9166666666667,0.18798955613577
"99","7190","7433",2,1,1,32.5,8,20.25,0.0987654320987654
"100","7190","7455",6,3,3,32.5,37.6666666666667,35.0833333333333,0.171021377672209
"101","7194","7233",9,6,3,38,27.1666666666667,32.5833333333333,0.276214833759591
"102","7194","7268",4,2,2,38,26.8333333333333,32.4166666666667,0.123393316195373
"103","7194","7286",6,3,3,38,26.1666666666667,32.0833333333333,0.187012987012987
"104","7194","7295",9,5,4,38,29.8333333333333,33.9166666666667,0.265356265356265
"105","7194","7313",5,2,3,38,30.1666666666667,34.0833333333333,0.146699266503667
"106","7194","7346",2,1,1,38,26.8333333333333,32.4166666666667,0.0616966580976864
"107","7194","7485",1,1,0,38,20.8333333333333,29.4166666666667,0.0339943342776204
"108","7197","6879",1,1,0,0.833333333333333,13,6.91666666666667,0.144578313253012
"109","7204","7218",1,1,0,2.83333333333333,28.6666666666667,15.75,0.0634920634920635
"110","7207","7010",10,4,6,45.6666666666667,44.5,45.0833333333333,0.22181146025878
"111","7207","7072",9,3,6,45.6666666666667,29.5,37.5833333333333,0.239467849223947
"112","7207","7220",2,2,0,45.6666666666667,31.8333333333333,38.75,0.0516129032258065
"113","7207","7222",1,1,0,45.6666666666667,16.5,31.0833333333333,0.032171581769437
"114","7207","7230",7,5,2,45.6666666666667,16.5,31.0833333333333,0.225201072386059
"115","7207","7253",1,1,0,45.6666666666667,27.1666666666667,36.4166666666667,0.0274599542334096
"116","7207","7267",17,8,9,45.6666666666667,35.5,40.5833333333333,0.418891170431212
"117","7207","7328",9,5,4,45.6666666666667,46.5,46.0833333333333,0.195298372513562
"118","7207","7391",1,1,0,45.6666666666667,25.8333333333333,35.75,0.027972027972028
"119","7207","7427",1,1,0,45.6666666666667,49.5,47.5833333333333,0.021015761821366
"120","7207","7453",1,1,0,45.6666666666667,34.3333333333333,40,0.025
"121","7207","7460",8,2,6,45.6666666666667,22.3333333333333,34,0.235294117647059
"122","7207","7472",2,2,0,45.6666666666667,33,39.3333333333333,0.0508474576271186
"123","7214","6879",1,1,0,1.66666666666667,13,7.33333333333333,0.136363636363636
"124","7218","6833",26,14,12,28.6666666666667,22.5,25.5833333333333,1.01628664495114
"125","7218","6879",2,1,1,28.6666666666667,13,20.8333333333333,0.096
"126","7218","7219",1,1,0,28.6666666666667,38.3333333333333,33.5,0.0298507462686567
"127","7218","7221",1,1,0,28.6666666666667,4.83333333333333,16.75,0.0597014925373134
"128","7218","7232",18,8,10,28.6666666666667,25.6666666666667,27.1666666666667,0.662576687116564
"129","7218","7443",1,1,0,28.6666666666667,18.1666666666667,23.4166666666667,0.0427046263345196
"130","7219","7218",2,1,1,38.3333333333333,28.6666666666667,33.5,0.0597014925373134
"131","7219","7232",3,2,1,38.3333333333333,25.6666666666667,32,0.09375
"132","7219","7263",11,3,8,38.3333333333333,50.8333333333333,44.5833333333333,0.246728971962617
"133","7219","7276",2,1,1,38.3333333333333,23.6666666666667,31,0.0645161290322581
"134","7219","7279",15,8,7,38.3333333333333,53.6666666666667,46,0.326086956521739
"135","7219","7315",2,2,0,38.3333333333333,28,33.1666666666667,0.0603015075376884
"136","7219","7427",1,1,0,38.3333333333333,49.5,43.9166666666667,0.0227703984819734
"137","7220","7186",9,3,6,31.8333333333333,29.3333333333333,30.5833333333333,0.294277929155313
"138","7220","7225",3,1,2,31.8333333333333,6.16666666666667,19,0.157894736842105
"139","7220","7253",10,6,4,31.8333333333333,27.1666666666667,29.5,0.338983050847458
"140","7220","7263",1,1,0,31.8333333333333,50.8333333333333,41.3333333333333,0.0241935483870968
"141","7220","7290",3,1,2,31.8333333333333,8.33333333333333,20.0833333333333,0.149377593360996
"142","7220","7291",3,3,0,31.8333333333333,26.5,29.1666666666667,0.102857142857143
"143","7220","7315",8,5,3,31.8333333333333,28,29.9166666666667,0.267409470752089
"144","7220","7342",4,3,1,31.8333333333333,28.5,30.1666666666667,0.132596685082873
"145","7220","7355",2,1,1,31.8333333333333,31.6666666666667,31.75,0.062992125984252
"146","7220","7456",5,3,2,31.8333333333333,13.3333333333333,22.5833333333333,0.22140221402214
"147","7220","7472",4,2,2,31.8333333333333,33,32.4166666666667,0.123393316195373
"148","7221","7055",2,2,0,4.83333333333333,2.16666666666667,3.5,0.571428571428571
"149","7221","7190",1,1,0,4.83333333333333,32.5,18.6666666666667,0.0535714285714286
"150","7221","7197",1,1,0,4.83333333333333,0.833333333333333,2.83333333333333,0.352941176470588
"151","7221","7214",1,1,0,4.83333333333333,1.66666666666667,3.25,0.307692307692308
"152","7221","7381",1,1,0,4.83333333333333,3.66666666666667,4.25,0.235294117647059
"153","7221","7474",1,1,0,4.83333333333333,1.16666666666667,3,0.333333333333333
"154","7221","7477",2,1,1,4.83333333333333,4.66666666666667,4.75,0.421052631578947
"155","7221","7482",4,3,1,4.83333333333333,1.83333333333333,3.33333333333333,1.2
"156","7222","7010",3,3,0,16.5,44.5,30.5,0.0983606557377049
"157","7222","7207",3,2,1,16.5,45.6666666666667,31.0833333333333,0.096514745308311
"158","7222","7253",2,1,1,16.5,27.1666666666667,21.8333333333333,0.0916030534351145
"159","7222","7255",1,1,0,16.5,33.6666666666667,25.0833333333333,0.0398671096345515
"160","7222","7267",1,1,0,16.5,35.5,26,0.0384615384615385
"161","7222","7291",1,1,0,16.5,26.5,21.5,0.0465116279069767
"162","7222","7472",2,2,0,16.5,33,24.75,0.0808080808080808
"163","7225","7253",3,2,1,6.16666666666667,27.1666666666667,16.6666666666667,0.18
"164","7225","7290",2,1,1,6.16666666666667,8.33333333333333,7.25,0.275862068965517
"165","7225","7315",1,1,0,6.16666666666667,28,17.0833333333333,0.0585365853658537
"166","7225","7456",1,1,0,6.16666666666667,13.3333333333333,9.75,0.102564102564103
"167","7227","7186",7,3,4,18,29.3333333333333,23.6666666666667,0.295774647887324
"168","7227","7220",6,6,0,18,31.8333333333333,24.9166666666667,0.240802675585284
"169","7227","7253",8,2,6,18,27.1666666666667,22.5833333333333,0.354243542435424
"170","7227","7290",5,2,3,18,8.33333333333333,13.1666666666667,0.379746835443038
"171","7227","7390",2,1,1,18,45,31.5,0.0634920634920635
"172","7227","7426",1,1,0,18,41.3333333333333,29.6666666666667,0.0337078651685393
"173","7227","7456",2,1,1,18,13.3333333333333,15.6666666666667,0.127659574468085
"174","7230","7010",5,2,3,16.5,44.5,30.5,0.163934426229508
"175","7230","7207",9,5,4,16.5,45.6666666666667,31.0833333333333,0.289544235924933
"176","7230","7222",1,1,0,16.5,16.5,16.5,0.0606060606060606
"177","7230","7267",3,1,2,16.5,35.5,26,0.115384615384615
"178","7230","7342",2,1,1,16.5,28.5,22.5,0.0888888888888889
"179","7232","6833",8,4,4,25.6666666666667,22.5,24.0833333333333,0.332179930795848
"180","7232","7218",7,1,6,25.6666666666667,28.6666666666667,27.1666666666667,0.257668711656442
"181","7232","7219",1,1,0,25.6666666666667,38.3333333333333,32,0.03125
"182","7232","7291",1,1,0,25.6666666666667,26.5,26.0833333333333,0.0383386581469649
"183","7232","7443",2,1,1,25.6666666666667,18.1666666666667,21.9166666666667,0.091254752851711
"184","7232","7453",1,1,0,25.6666666666667,34.3333333333333,30,0.0333333333333333
"185","7233","6937",1,1,0,27.1666666666667,20.3333333333333,23.75,0.0421052631578947
"186","7233","7194",8,5,3,27.1666666666667,38,32.5833333333333,0.245524296675192
"187","7233","7268",4,3,1,27.1666666666667,26.8333333333333,27,0.148148148148148
"188","7233","7286",13,5,8,27.1666666666667,26.1666666666667,26.6666666666667,0.4875
"189","7233","7295",10,3,7,27.1666666666667,29.8333333333333,28.5,0.350877192982456
"190","7233","7313",5,2,3,27.1666666666667,30.1666666666667,28.6666666666667,0.174418604651163
"191","7233","7346",1,1,0,27.1666666666667,26.8333333333333,27,0.037037037037037
"192","7234","6814",2,2,0,28.3333333333333,12,20.1666666666667,0.0991735537190083
"193","7234","7072",1,1,0,28.3333333333333,29.5,28.9166666666667,0.0345821325648415
"194","7234","7220",1,1,0,28.3333333333333,31.8333333333333,30.0833333333333,0.0332409972299169
"195","7234","7230",1,1,0,28.3333333333333,16.5,22.4166666666667,0.0446096654275093
"196","7234","7255",10,5,5,28.3333333333333,33.6666666666667,31,0.32258064516129
"197","7234","7265",6,4,2,28.3333333333333,16.1666666666667,22.25,0.269662921348315
"198","7234","7391",7,3,4,28.3333333333333,25.8333333333333,27.0833333333333,0.258461538461538
"199","7234","7462",3,1,2,28.3333333333333,13.1666666666667,20.75,0.144578313253012
"200","7236","7038",5,4,1,23.5,26.8333333333333,25.1666666666667,0.198675496688742
"201","7236","7271",4,3,1,23.5,17,20.25,0.197530864197531
"202","7236","7274",2,2,0,23.5,13.5,18.5,0.108108108108108
"203","7236","7280",5,1,4,23.5,15.3333333333333,19.4166666666667,0.257510729613734
"204","7236","7334",13,2,11,23.5,28,25.75,0.504854368932039
"205","7236","7339",10,6,4,23.5,22.8333333333333,23.1666666666667,0.431654676258993
"206","7236","7366",2,1,1,23.5,7.5,15.5,0.129032258064516
"207","7236","7369",1,1,0,23.5,23.6666666666667,23.5833333333333,0.0424028268551237
"208","7246","6818",4,4,0,50.5,NA,NA,NA
"209","7246","7038",1,1,0,50.5,26.8333333333333,38.6666666666667,0.0258620689655172
"210","7246","7298",19,8,11,50.5,47.8333333333333,49.1666666666667,0.386440677966102
"211","7246","7323",4,2,2,50.5,6.5,28.5,0.140350877192982
"212","7246","7324",14,7,7,50.5,48.8333333333333,49.6666666666667,0.281879194630872
"213","7246","7328",4,2,2,50.5,46.5,48.5,0.0824742268041237
"214","7246","7367",1,1,0,50.5,16,33.25,0.0300751879699248
"215","7246","7398",3,3,0,50.5,7.33333333333333,28.9166666666667,0.103746397694524
"216","7246","7427",12,4,8,50.5,49.5,50,0.24
"217","7246","7448",10,1,9,50.5,23.6666666666667,37.0833333333333,0.269662921348315
"218","7246","7461",13,7,6,50.5,29.6666666666667,40.0833333333333,0.324324324324324
"219","7253","7186",4,3,1,27.1666666666667,29.3333333333333,28.25,0.141592920353982
"220","7253","7220",7,4,3,27.1666666666667,31.8333333333333,29.5,0.23728813559322
"221","7253","7227",3,1,2,27.1666666666667,18,22.5833333333333,0.132841328413284
"222","7253","7291",1,1,0,27.1666666666667,26.5,26.8333333333333,0.0372670807453416
"223","7253","7315",3,1,2,27.1666666666667,28,27.5833333333333,0.108761329305136
"224","7253","7342",1,1,0,27.1666666666667,28.5,27.8333333333333,0.0359281437125748
"225","7253","7355",4,2,2,27.1666666666667,31.6666666666667,29.4166666666667,0.135977337110482
"226","7253","7380",1,1,0,27.1666666666667,27.8333333333333,27.5,0.0363636363636364
"227","7253","7456",1,1,0,27.1666666666667,13.3333333333333,20.25,0.0493827160493827
"228","7253","7472",2,2,0,27.1666666666667,33,30.0833333333333,0.0664819944598338
"229","7255","6814",10,3,7,33.6666666666667,12,22.8333333333333,0.437956204379562
"230","7255","7010",1,1,0,33.6666666666667,44.5,39.0833333333333,0.0255863539445629
"231","7255","7072",3,3,0,33.6666666666667,29.5,31.5833333333333,0.0949868073878628
"232","7255","7186",1,1,0,33.6666666666667,29.3333333333333,31.5,0.0317460317460317
"233","7255","7220",2,2,0,33.6666666666667,31.8333333333333,32.75,0.0610687022900763
"234","7255","7234",8,4,4,33.6666666666667,28.3333333333333,31,0.258064516129032
"235","7255","7265",3,2,1,33.6666666666667,16.1666666666667,24.9166666666667,0.120401337792642
"236","7255","7391",7,4,3,33.6666666666667,25.8333333333333,29.75,0.235294117647059
"237","7255","7462",7,3,4,33.6666666666667,13.1666666666667,23.4166666666667,0.298932384341637
"238","7255","7472",8,5,3,33.6666666666667,33,33.3333333333333,0.24
"239","7263","6833",2,1,1,50.8333333333333,22.5,36.6666666666667,0.0545454545454545
"240","7263","7010",1,1,0,50.8333333333333,44.5,47.6666666666667,0.020979020979021
"241","7263","7219",10,3,7,50.8333333333333,38.3333333333333,44.5833333333333,0.224299065420561
"242","7263","7232",2,2,0,50.8333333333333,25.6666666666667,38.25,0.0522875816993464
"243","7263","7279",12,4,8,50.8333333333333,53.6666666666667,52.25,0.229665071770335
"244","7263","7384",1,1,0,50.8333333333333,11.5,31.1666666666667,0.0320855614973262
"245","7263","7450",1,1,0,50.8333333333333,3.16666666666667,27,0.037037037037037
"246","7265","6814",2,1,1,16.1666666666667,12,14.0833333333333,0.142011834319527
"247","7265","7072",1,1,0,16.1666666666667,29.5,22.8333333333333,0.0437956204379562
"248","7265","7207",3,1,2,16.1666666666667,45.6666666666667,30.9166666666667,0.0970350404312669
"249","7265","7234",4,2,2,16.1666666666667,28.3333333333333,22.25,0.179775280898876
"250","7265","7255",3,1,2,16.1666666666667,33.6666666666667,24.9166666666667,0.120401337792642
"251","7265","7391",3,1,2,16.1666666666667,25.8333333333333,21,0.142857142857143
"252","7265","7462",2,1,1,16.1666666666667,13.1666666666667,14.6666666666667,0.136363636363636
"253","7267","7010",14,9,5,35.5,44.5,40,0.35
"254","7267","7072",8,5,3,35.5,29.5,32.5,0.246153846153846
"255","7267","7207",18,7,11,35.5,45.6666666666667,40.5833333333333,0.4435318275154
"256","7267","7230",5,2,3,35.5,16.5,26,0.192307692307692
"257","7267","7255",1,1,0,35.5,33.6666666666667,34.5833333333333,0.0289156626506024
"258","7267","7265",2,1,1,35.5,16.1666666666667,25.8333333333333,0.0774193548387097
"259","7267","7328",3,1,2,35.5,46.5,41,0.0731707317073171
"260","7267","7427",1,1,0,35.5,49.5,42.5,0.0235294117647059
"261","7267","7453",1,1,0,35.5,34.3333333333333,34.9166666666667,0.0286396181384248
"262","7268","7194",9,2,7,26.8333333333333,38,32.4166666666667,0.277634961439589
"263","7268","7233",9,1,8,26.8333333333333,27.1666666666667,27,0.333333333333333
"264","7268","7270",1,1,0,26.8333333333333,30.3333333333333,28.5833333333333,0.0349854227405248
"265","7268","7286",3,3,0,26.8333333333333,26.1666666666667,26.5,0.113207547169811
"266","7268","7295",10,4,6,26.8333333333333,29.8333333333333,28.3333333333333,0.352941176470588
"267","7268","7304",1,1,0,26.8333333333333,1.66666666666667,14.25,0.0701754385964912
"268","7268","7313",5,3,2,26.8333333333333,30.1666666666667,28.5,0.175438596491228
"269","7268","7346",9,2,7,26.8333333333333,26.8333333333333,26.8333333333333,0.335403726708075
"270","7270","7345",6,1,5,30.3333333333333,30.5,30.4166666666667,0.197260273972603
"271","7270","7352",7,1,6,30.3333333333333,8.66666666666667,19.5,0.358974358974359
"272","7270","7407",7,1,6,30.3333333333333,31.3333333333333,30.8333333333333,0.227027027027027
"273","7270","7455",6,2,4,30.3333333333333,37.6666666666667,34,0.176470588235294
"274","7271","7038",8,4,4,17,26.8333333333333,21.9166666666667,0.365019011406844
"275","7271","7236",3,2,1,17,23.5,20.25,0.148148148148148
"276","7271","7274",3,3,0,17,13.5,15.25,0.19672131147541
"277","7271","7280",5,3,2,17,15.3333333333333,16.1666666666667,0.309278350515464
"278","7271","7334",6,3,3,17,28,22.5,0.266666666666667
"279","7271","7339",10,5,5,17,22.8333333333333,19.9166666666667,0.502092050209205
"280","7271","7369",4,2,2,17,23.6666666666667,20.3333333333333,0.19672131147541
"281","7274","7038",7,3,4,13.5,26.8333333333333,20.1666666666667,0.347107438016529
"282","7274","7271",2,2,0,13.5,17,15.25,0.131147540983607
"283","7274","7334",4,2,2,13.5,28,20.75,0.192771084337349
"284","7274","7339",5,1,4,13.5,22.8333333333333,18.1666666666667,0.275229357798165
"285","7274","7369",6,4,2,13.5,23.6666666666667,18.5833333333333,0.322869955156951
"286","7276","7040",1,1,0,23.6666666666667,39.5,31.5833333333333,0.0316622691292876
"287","7276","7291",1,1,0,23.6666666666667,26.5,25.0833333333333,0.0398671096345515
"288","7276","7315",3,2,1,23.6666666666667,28,25.8333333333333,0.116129032258065
"289","7276","7355",2,1,1,23.6666666666667,31.6666666666667,27.6666666666667,0.072289156626506
"290","7276","7386",1,1,0,23.6666666666667,41,32.3333333333333,0.0309278350515464
"291","7278","6833",1,1,0,15,22.5,18.75,0.0533333333333333
"292","7278","6879",5,1,4,15,13,14,0.357142857142857
"293","7278","6888",11,4,7,15,11.5,13.25,0.830188679245283
"294","7278","7207",1,1,0,15,45.6666666666667,30.3333333333333,0.032967032967033
"295","7278","7340",1,1,0,15,11,13,0.0769230769230769
"296","7278","7366",2,1,1,15,7.5,11.25,0.177777777777778
"297","7279","7219",15,4,11,53.6666666666667,38.3333333333333,46,0.326086956521739
"298","7279","7263",18,7,11,53.6666666666667,50.8333333333333,52.25,0.344497607655502
"299","7279","7324",1,1,0,53.6666666666667,48.8333333333333,51.25,0.0195121951219512
"300","7279","7453",1,1,0,53.6666666666667,34.3333333333333,44,0.0227272727272727
"301","7280","7038",7,4,3,15.3333333333333,26.8333333333333,21.0833333333333,0.33201581027668
"302","7280","7236",2,1,1,15.3333333333333,23.5,19.4166666666667,0.103004291845494
"303","7280","7274",5,2,3,15.3333333333333,13.5,14.4166666666667,0.346820809248555
"304","7280","7295",1,1,0,15.3333333333333,29.8333333333333,22.5833333333333,0.044280442804428
"305","7280","7334",5,3,2,15.3333333333333,28,21.6666666666667,0.230769230769231
"306","7280","7339",4,2,2,15.3333333333333,22.8333333333333,19.0833333333333,0.209606986899563
"307","7280","7369",7,4,3,15.3333333333333,23.6666666666667,19.5,0.358974358974359
"308","7286","7083",1,1,0,26.1666666666667,27.3333333333333,26.75,0.0373831775700935
"309","7286","7194",6,4,2,26.1666666666667,38,32.0833333333333,0.187012987012987
"310","7286","7233",7,4,3,26.1666666666667,27.1666666666667,26.6666666666667,0.2625
"311","7286","7268",2,1,1,26.1666666666667,26.8333333333333,26.5,0.0754716981132075
"312","7286","7295",5,2,3,26.1666666666667,29.8333333333333,28,0.178571428571429
"313","7286","7313",9,4,5,26.1666666666667,30.1666666666667,28.1666666666667,0.319526627218935
"314","7290","7225",2,1,1,8.33333333333333,6.16666666666667,7.25,0.275862068965517
"315","7290","7227",1,1,0,8.33333333333333,18,13.1666666666667,0.0759493670886076
"316","7291","7186",1,1,0,26.5,29.3333333333333,27.9166666666667,0.0358208955223881
"317","7291","7220",9,5,4,26.5,31.8333333333333,29.1666666666667,0.308571428571429
"318","7291","7222",1,1,0,26.5,16.5,21.5,0.0465116279069767
"319","7291","7253",5,3,2,26.5,27.1666666666667,26.8333333333333,0.186335403726708
"320","7291","7276",2,1,1,26.5,23.6666666666667,25.0833333333333,0.079734219269103
"321","7291","7315",9,3,6,26.5,28,27.25,0.330275229357798
"322","7291","7342",15,7,8,26.5,28.5,27.5,0.545454545454545
"323","7291","7355",2,1,1,26.5,31.6666666666667,29.0833333333333,0.0687679083094556
"324","7291","7380",7,2,5,26.5,27.8333333333333,27.1666666666667,0.257668711656442
"325","7291","7472",1,1,0,26.5,33,29.75,0.0336134453781513
"326","7291","7477",2,2,0,26.5,4.66666666666667,15.5833333333333,0.128342245989305
"327","7295","7040",1,1,0,29.8333333333333,39.5,34.6666666666667,0.0288461538461538
"328","7295","7194",3,1,2,29.8333333333333,38,33.9166666666667,0.0884520884520885
"329","7295","7268",9,5,4,29.8333333333333,26.8333333333333,28.3333333333333,0.317647058823529
"330","7295","7280",3,1,2,29.8333333333333,15.3333333333333,22.5833333333333,0.132841328413284
"331","7295","7286",10,6,4,29.8333333333333,26.1666666666667,28,0.357142857142857
"332","7295","7313",6,1,5,29.8333333333333,30.1666666666667,30,0.2
"333","7295","7346",6,2,4,29.8333333333333,26.8333333333333,28.3333333333333,0.211764705882353
"334","7295","7386",1,1,0,29.8333333333333,41,35.4166666666667,0.0282352941176471
"335","7298","6818",6,6,0,47.8333333333333,NA,NA,NA
"336","7298","7246",22,9,13,47.8333333333333,50.5,49.1666666666667,0.447457627118644
"337","7298","7323",1,1,0,47.8333333333333,6.5,27.1666666666667,0.0368098159509202
"338","7298","7324",10,3,7,47.8333333333333,48.8333333333333,48.3333333333333,0.206896551724138
"339","7298","7328",7,3,4,47.8333333333333,46.5,47.1666666666667,0.148409893992933
"340","7298","7427",11,6,5,47.8333333333333,49.5,48.6666666666667,0.226027397260274
"341","7298","7448",10,6,4,47.8333333333333,23.6666666666667,35.75,0.27972027972028
"342","7298","7453",10,4,6,47.8333333333333,34.3333333333333,41.0833333333333,0.243407707910751
"343","7298","7461",19,9,10,47.8333333333333,29.6666666666667,38.75,0.490322580645161
"344","7302","7190",8,2,6,39,32.5,35.75,0.223776223776224
"345","7302","7270",5,1,4,39,30.3333333333333,34.6666666666667,0.144230769230769
"346","7302","7334",1,1,0,39,28,33.5,0.0298507462686567
"347","7302","7345",9,2,7,39,30.5,34.75,0.258992805755396
"348","7302","7352",5,3,2,39,8.66666666666667,23.8333333333333,0.20979020979021
"349","7302","7407",19,5,14,39,31.3333333333333,35.1666666666667,0.540284360189573
"350","7302","7455",8,4,4,39,37.6666666666667,38.3333333333333,0.208695652173913
"351","7302","7480",1,1,0,39,42.6666666666667,40.8333333333333,0.0244897959183673
"352","7304","7486",2,2,0,1.66666666666667,0.666666666666667,1.16666666666667,1.71428571428571
"353","7313","7194",8,3,5,30.1666666666667,38,34.0833333333333,0.234718826405868
"354","7313","7233",14,5,9,30.1666666666667,27.1666666666667,28.6666666666667,0.488372093023256
"355","7313","7268",9,3,6,30.1666666666667,26.8333333333333,28.5,0.315789473684211
"356","7313","7286",15,7,8,30.1666666666667,26.1666666666667,28.1666666666667,0.532544378698225
"357","7313","7295",10,4,6,30.1666666666667,29.8333333333333,30,0.333333333333333
"358","7314","6888",4,1,3,11.6666666666667,11.5,11.5833333333333,0.345323741007194
"359","7314","7278",8,5,3,11.6666666666667,15,13.3333333333333,0.6
"360","7314","7340",2,1,1,11.6666666666667,11,11.3333333333333,0.176470588235294
"361","7314","7366",4,2,2,11.6666666666667,7.5,9.58333333333333,0.417391304347826
"362","7314","7390",1,1,0,11.6666666666667,45,28.3333333333333,0.0352941176470588
"363","7315","7222",2,1,1,28,16.5,22.25,0.0898876404494382
"364","7315","7253",5,2,3,28,27.1666666666667,27.5833333333333,0.181268882175227
"365","7315","7276",4,2,2,28,23.6666666666667,25.8333333333333,0.154838709677419
"366","7315","7290",1,1,0,28,8.33333333333333,18.1666666666667,0.055045871559633
"367","7315","7291",6,3,3,28,26.5,27.25,0.220183486238532
"368","7315","7342",9,3,6,28,28.5,28.25,0.31858407079646
"369","7315","7355",5,2,3,28,31.6666666666667,29.8333333333333,0.167597765363128
"370","7315","7380",7,2,5,28,27.8333333333333,27.9166666666667,0.250746268656716
"371","7315","7460",1,1,0,28,22.3333333333333,25.1666666666667,0.0397350993377483
"372","7323","7246",4,4,0,6.5,50.5,28.5,0.140350877192982
"373","7323","7298",4,1,3,6.5,47.8333333333333,27.1666666666667,0.147239263803681
"374","7323","7328",3,1,2,6.5,46.5,26.5,0.113207547169811
"375","7323","7398",2,1,1,6.5,7.33333333333333,6.91666666666667,0.289156626506024
"376","7324","6818",19,19,0,48.8333333333333,NA,NA,NA
"377","7324","7010",1,1,0,48.8333333333333,44.5,46.6666666666667,0.0214285714285714
"378","7324","7246",15,6,9,48.8333333333333,50.5,49.6666666666667,0.302013422818792
"379","7324","7298",12,6,6,48.8333333333333,47.8333333333333,48.3333333333333,0.248275862068966
"380","7324","7323",7,5,2,48.8333333333333,6.5,27.6666666666667,0.253012048192771
"381","7324","7328",6,4,2,48.8333333333333,46.5,47.6666666666667,0.125874125874126
"382","7324","7339",2,1,1,48.8333333333333,22.8333333333333,35.8333333333333,0.0558139534883721
"383","7324","7363",1,1,0,48.8333333333333,5.33333333333333,27.0833333333333,0.0369230769230769
"384","7324","7398",3,3,0,48.8333333333333,7.33333333333333,28.0833333333333,0.106824925816024
"385","7324","7427",11,6,5,48.8333333333333,49.5,49.1666666666667,0.223728813559322
"386","7324","7461",11,2,9,48.8333333333333,29.6666666666667,39.25,0.280254777070064
"387","7328","7010",2,2,0,46.5,44.5,45.5,0.043956043956044
"388","7328","7072",4,1,3,46.5,29.5,38,0.105263157894737
"389","7328","7207",6,2,4,46.5,45.6666666666667,46.0833333333333,0.130198915009042
"390","7328","7222",1,1,0,46.5,16.5,31.5,0.0317460317460317
"391","7328","7246",2,1,1,46.5,50.5,48.5,0.0412371134020619
"392","7328","7263",2,1,1,46.5,50.8333333333333,48.6666666666667,0.0410958904109589
"393","7328","7267",3,1,2,46.5,35.5,41,0.0731707317073171
"394","7328","7298",3,2,1,46.5,47.8333333333333,47.1666666666667,0.0636042402826855
"395","7328","7324",4,1,3,46.5,48.8333333333333,47.6666666666667,0.0839160839160839
"396","7328","7340",1,1,0,46.5,11,28.75,0.0347826086956522
"397","7328","7448",4,4,0,46.5,23.6666666666667,35.0833333333333,0.114014251781473
"398","7334","7038",10,4,6,28,26.8333333333333,27.4166666666667,0.364741641337386
"399","7334","7218",1,1,0,28,28.6666666666667,28.3333333333333,0.0352941176470588
"400","7334","7236",7,2,5,28,23.5,25.75,0.271844660194175
"401","7334","7271",7,4,3,28,17,22.5,0.311111111111111
"402","7334","7274",10,2,8,28,13.5,20.75,0.481927710843373
"403","7334","7280",6,3,3,28,15.3333333333333,21.6666666666667,0.276923076923077
"404","7334","7339",9,1,8,28,22.8333333333333,25.4166666666667,0.354098360655738
"405","7334","7369",7,3,4,28,23.6666666666667,25.8333333333333,0.270967741935484
"406","7334","7450",1,1,0,28,3.16666666666667,15.5833333333333,0.0641711229946524
"407","7339","6879",1,1,0,22.8333333333333,13,17.9166666666667,0.0558139534883721
"408","7339","7038",5,1,4,22.8333333333333,26.8333333333333,24.8333333333333,0.201342281879195
"409","7339","7186",1,1,0,22.8333333333333,29.3333333333333,26.0833333333333,0.0383386581469649
"410","7339","7236",7,2,5,22.8333333333333,23.5,23.1666666666667,0.302158273381295
"411","7339","7271",7,5,2,22.8333333333333,17,19.9166666666667,0.351464435146444
"412","7339","7280",3,2,1,22.8333333333333,15.3333333333333,19.0833333333333,0.157205240174672
"413","7339","7334",9,6,3,22.8333333333333,28,25.4166666666667,0.354098360655738
"414","7339","7369",10,5,5,22.8333333333333,23.6666666666667,23.25,0.43010752688172
"415","7340","6879",1,1,0,11,13,12,0.0833333333333333
"416","7340","6888",5,3,2,11,11.5,11.25,0.444444444444444
"417","7340","7194",1,1,0,11,38,24.5,0.0408163265306122
"418","7340","7278",1,1,0,11,15,13,0.0769230769230769
"419","7340","7286",1,1,0,11,26.1666666666667,18.5833333333333,0.0538116591928251
"420","7340","7295",1,1,0,11,29.8333333333333,20.4166666666667,0.0489795918367347
"421","7340","7366",4,2,2,11,7.5,9.25,0.432432432432432
"422","7340","7399",1,1,0,11,1.16666666666667,6.08333333333333,0.164383561643836
"423","7342","7220",2,1,1,28.5,31.8333333333333,30.1666666666667,0.0662983425414365
"424","7342","7230",1,1,0,28.5,16.5,22.5,0.0444444444444444
"425","7342","7253",3,3,0,28.5,27.1666666666667,27.8333333333333,0.107784431137725
"426","7342","7276",3,3,0,28.5,23.6666666666667,26.0833333333333,0.115015974440895
"427","7342","7291",6,3,3,28.5,26.5,27.5,0.218181818181818
"428","7342","7315",5,3,2,28.5,28,28.25,0.176991150442478
"429","7342","7380",8,2,6,28.5,27.8333333333333,28.1666666666667,0.284023668639053
"430","7342","7384",4,1,3,28.5,11.5,20,0.2
"431","7342","7472",1,1,0,28.5,33,30.75,0.032520325203252
"432","7345","7190",10,1,9,30.5,32.5,31.5,0.317460317460317
"433","7345","7270",9,3,6,30.5,30.3333333333333,30.4166666666667,0.295890410958904
"434","7345","7302",7,2,5,30.5,39,34.75,0.201438848920863
"435","7345","7352",4,2,2,30.5,8.66666666666667,19.5833333333333,0.204255319148936
"436","7345","7386",1,1,0,30.5,41,35.75,0.027972027972028
"437","7345","7407",10,4,6,30.5,31.3333333333333,30.9166666666667,0.32345013477089
"438","7345","7433",5,3,2,30.5,8,19.25,0.25974025974026
"439","7345","7455",8,1,7,30.5,37.6666666666667,34.0833333333333,0.234718826405868
"440","7346","7194",3,2,1,26.8333333333333,38,32.4166666666667,0.0925449871465296
"441","7346","7233",5,2,3,26.8333333333333,27.1666666666667,27,0.185185185185185
"442","7346","7286",1,1,0,26.8333333333333,26.1666666666667,26.5,0.0377358490566038
"443","7346","7295",6,3,3,26.8333333333333,29.8333333333333,28.3333333333333,0.211764705882353
"444","7346","7313",3,3,0,26.8333333333333,30.1666666666667,28.5,0.105263157894737
"445","7346","7369",1,1,0,26.8333333333333,23.6666666666667,25.25,0.0396039603960396
"446","7352","7270",5,3,2,8.66666666666667,30.3333333333333,19.5,0.256410256410256
"447","7352","7302",4,2,2,8.66666666666667,39,23.8333333333333,0.167832167832168
"448","7352","7407",4,2,2,8.66666666666667,31.3333333333333,20,0.2
"449","7355","7186",3,1,2,31.6666666666667,29.3333333333333,30.5,0.0983606557377049
"450","7355","7232",1,1,0,31.6666666666667,25.6666666666667,28.6666666666667,0.0348837209302326
"451","7355","7253",3,1,2,31.6666666666667,27.1666666666667,29.4166666666667,0.101983002832861
"452","7355","7276",4,1,3,31.6666666666667,23.6666666666667,27.6666666666667,0.144578313253012
"453","7355","7291",6,4,2,31.6666666666667,26.5,29.0833333333333,0.206303724928367
"454","7355","7315",4,2,2,31.6666666666667,28,29.8333333333333,0.134078212290503
"455","7355","7342",8,3,5,31.6666666666667,28.5,30.0833333333333,0.265927977839335
"456","7355","7380",10,6,4,31.6666666666667,27.8333333333333,29.75,0.336134453781513
"457","7355","7384",1,1,0,31.6666666666667,11.5,21.5833333333333,0.0463320463320463
"458","7355","7443",1,1,0,31.6666666666667,18.1666666666667,24.9166666666667,0.040133779264214
"459","7355","7460",1,1,0,31.6666666666667,22.3333333333333,27,0.037037037037037
"460","7366","6879",2,1,1,7.5,13,10.25,0.195121951219512
"461","7366","6888",13,6,7,7.5,11.5,9.5,1.36842105263158
"462","7366","7278",5,3,2,7.5,15,11.25,0.444444444444444
"463","7366","7340",4,3,1,7.5,11,9.25,0.432432432432432
"464","7367","7190",8,6,2,16,32.5,24.25,0.329896907216495
"465","7367","7345",6,2,4,16,30.5,23.25,0.258064516129032
"466","7367","7407",5,1,4,16,31.3333333333333,23.6666666666667,0.211267605633803
"467","7367","7433",3,1,2,16,8,12,0.25
"468","7367","7455",6,1,5,16,37.6666666666667,26.8333333333333,0.22360248447205
"469","7369","7236",4,1,3,23.6666666666667,23.5,23.5833333333333,0.169611307420495
"470","7369","7271",7,2,5,23.6666666666667,17,20.3333333333333,0.344262295081967
"471","7369","7274",2,1,1,23.6666666666667,13.5,18.5833333333333,0.10762331838565
"472","7369","7334",7,1,6,23.6666666666667,28,25.8333333333333,0.270967741935484
"473","7369","7339",6,2,4,23.6666666666667,22.8333333333333,23.25,0.258064516129032
"474","7369","7410",1,1,0,23.6666666666667,41.6666666666667,32.6666666666667,0.0306122448979592
"475","7380","7040",1,1,0,27.8333333333333,39.5,33.6666666666667,0.0297029702970297
"476","7380","7253",1,1,0,27.8333333333333,27.1666666666667,27.5,0.0363636363636364
"477","7380","7276",3,2,1,27.8333333333333,23.6666666666667,25.75,0.116504854368932
"478","7380","7291",7,1,6,27.8333333333333,26.5,27.1666666666667,0.257668711656442
"479","7380","7315",8,4,4,27.8333333333333,28,27.9166666666667,0.286567164179104
"480","7380","7342",14,5,9,27.8333333333333,28.5,28.1666666666667,0.497041420118343
"481","7380","7355",9,2,7,27.8333333333333,31.6666666666667,29.75,0.302521008403361
"482","7380","7384",4,1,3,27.8333333333333,11.5,19.6666666666667,0.203389830508475
"483","7380","7455",1,1,0,27.8333333333333,37.6666666666667,32.75,0.0305343511450382
"484","7380","7472",1,1,0,27.8333333333333,33,30.4166666666667,0.0328767123287671
"485","7381","7304",1,1,0,3.66666666666667,1.66666666666667,2.66666666666667,0.375
"486","7381","7363",4,4,0,3.66666666666667,5.33333333333333,4.5,0.888888888888889
"487","7384","7291",1,1,0,11.5,26.5,19,0.0526315789473684
"488","7384","7315",3,1,2,11.5,28,19.75,0.151898734177215
"489","7384","7342",3,1,2,11.5,28.5,20,0.15
"490","7384","7380",3,3,0,11.5,27.8333333333333,19.6666666666667,0.152542372881356
"491","7386","7040",10,6,4,41,39.5,40.25,0.248447204968944
"492","7386","7139",10,2,8,41,36.6666666666667,38.8333333333333,0.257510729613734
"493","7386","7390",10,2,8,41,45,43,0.232558139534884
"494","7386","7410",13,4,9,41,41.6666666666667,41.3333333333333,0.314516129032258
"495","7386","7426",11,1,10,41,41.3333333333333,41.1666666666667,0.267206477732793
"496","7386","7452",1,1,0,41,2.16666666666667,21.5833333333333,0.0463320463320463
"497","7386","7480",5,4,1,41,42.6666666666667,41.8333333333333,0.119521912350598
"498","7386","7485",6,1,5,41,20.8333333333333,30.9166666666667,0.194070080862534
"499","7390","7040",13,3,10,45,39.5,42.25,0.307692307692308
"500","7390","7139",13,6,7,45,36.6666666666667,40.8333333333333,0.318367346938776
"501","7390","7345",2,2,0,45,30.5,37.75,0.0529801324503311
"502","7390","7355",1,1,0,45,31.6666666666667,38.3333333333333,0.0260869565217391
"503","7390","7384",1,1,0,45,11.5,28.25,0.0353982300884956
"504","7390","7386",17,2,15,45,41,43,0.395348837209302
"505","7390","7410",13,4,9,45,41.6666666666667,43.3333333333333,0.3
"506","7390","7426",24,8,16,45,41.3333333333333,43.1666666666667,0.555984555984556
"507","7390","7480",10,5,5,45,42.6666666666667,43.8333333333333,0.228136882129278
"508","7390","7485",9,2,7,45,20.8333333333333,32.9166666666667,0.273417721518987
"509","7391","6814",5,1,4,25.8333333333333,12,18.9166666666667,0.26431718061674
"510","7391","6905",1,1,0,25.8333333333333,1.16666666666667,13.5,0.0740740740740741
"511","7391","7072",1,1,0,25.8333333333333,29.5,27.6666666666667,0.036144578313253
"512","7391","7234",12,4,8,25.8333333333333,28.3333333333333,27.0833333333333,0.443076923076923
"513","7391","7255",7,3,4,25.8333333333333,33.6666666666667,29.75,0.235294117647059
"514","7391","7265",4,2,2,25.8333333333333,16.1666666666667,21,0.19047619047619
"515","7391","7462",4,1,3,25.8333333333333,13.1666666666667,19.5,0.205128205128205
"516","7398","7298",4,4,0,7.33333333333333,47.8333333333333,27.5833333333333,0.145015105740181
"517","7398","7323",3,2,1,7.33333333333333,6.5,6.91666666666667,0.433734939759036
"518","7398","7324",5,3,2,7.33333333333333,48.8333333333333,28.0833333333333,0.178041543026706
"519","7407","7190",7,2,5,31.3333333333333,32.5,31.9166666666667,0.219321148825065
"520","7407","7270",9,2,7,31.3333333333333,30.3333333333333,30.8333333333333,0.291891891891892
"521","7407","7302",15,9,6,31.3333333333333,39,35.1666666666667,0.42654028436019
"522","7407","7345",3,1,2,31.3333333333333,30.5,30.9166666666667,0.0970350404312669
"523","7407","7352",3,2,1,31.3333333333333,8.66666666666667,20,0.15
"524","7407","7367",5,1,4,31.3333333333333,16,23.6666666666667,0.211267605633803
"525","7407","7455",8,4,4,31.3333333333333,37.6666666666667,34.5,0.231884057971014
"526","7410","7040",10,2,8,41.6666666666667,39.5,40.5833333333333,0.246406570841889
"527","7410","7139",11,2,9,41.6666666666667,36.6666666666667,39.1666666666667,0.280851063829787
"528","7410","7386",14,4,10,41.6666666666667,41,41.3333333333333,0.338709677419355
"529","7410","7390",13,6,7,41.6666666666667,45,43.3333333333333,0.3
"530","7410","7426",10,3,7,41.6666666666667,41.3333333333333,41.5,0.240963855421687
"531","7410","7480",12,3,9,41.6666666666667,42.6666666666667,42.1666666666667,0.284584980237154
"532","7410","7485",5,2,3,41.6666666666667,20.8333333333333,31.25,0.16
"533","7424","6937",10,7,3,32.1666666666667,20.3333333333333,26.25,0.380952380952381
"534","7424","7083",5,3,2,32.1666666666667,27.3333333333333,29.75,0.168067226890756
"535","7424","7207",2,1,1,32.1666666666667,45.6666666666667,38.9166666666667,0.0513918629550321
"536","7424","7425",3,2,1,32.1666666666667,4.66666666666667,18.4166666666667,0.16289592760181
"537","7424","7430",1,1,0,32.1666666666667,2.66666666666667,17.4166666666667,0.0574162679425837
"538","7424","7475",9,4,5,32.1666666666667,27.1666666666667,29.6666666666667,0.303370786516854
"539","7424","7479",5,1,4,32.1666666666667,16,24.0833333333333,0.207612456747405
"540","7425","7083",3,2,1,4.66666666666667,27.3333333333333,16,0.1875
"541","7426","7040",6,3,3,41.3333333333333,39.5,40.4166666666667,0.148453608247423
"542","7426","7346",1,1,0,41.3333333333333,26.8333333333333,34.0833333333333,0.0293398533007335
"543","7426","7386",15,3,12,41.3333333333333,41,41.1666666666667,0.364372469635627
"544","7426","7390",18,6,12,41.3333333333333,45,43.1666666666667,0.416988416988417
"545","7426","7410",9,5,4,41.3333333333333,41.6666666666667,41.5,0.216867469879518
"546","7426","7424",1,1,0,41.3333333333333,32.1666666666667,36.75,0.0272108843537415
"547","7426","7480",11,4,7,41.3333333333333,42.6666666666667,42,0.261904761904762
"548","7426","7485",11,2,9,41.3333333333333,20.8333333333333,31.0833333333333,0.353887399463807
"549","7427","6818",4,4,0,49.5,NA,NA,NA
"550","7427","7222",1,1,0,49.5,16.5,33,0.0303030303030303
"551","7427","7246",9,2,7,49.5,50.5,50,0.18
"552","7427","7263",1,1,0,49.5,50.8333333333333,50.1666666666667,0.0199335548172757
"553","7427","7298",11,7,4,49.5,47.8333333333333,48.6666666666667,0.226027397260274
"554","7427","7323",1,1,0,49.5,6.5,28,0.0357142857142857
"555","7427","7324",20,10,10,49.5,48.8333333333333,49.1666666666667,0.406779661016949
"556","7427","7328",3,3,0,49.5,46.5,48,0.0625
"557","7427","7448",7,2,5,49.5,23.6666666666667,36.5833333333333,0.191343963553531
"558","7427","7453",4,1,3,49.5,34.3333333333333,41.9166666666667,0.0954274353876739
"559","7427","7461",8,2,6,49.5,29.6666666666667,39.5833333333333,0.202105263157895
"560","7427","7472",1,1,0,49.5,33,41.25,0.0242424242424242
"561","7430","7424",1,1,0,2.66666666666667,32.1666666666667,17.4166666666667,0.0574162679425837
"562","7430","7475",1,1,0,2.66666666666667,27.1666666666667,14.9166666666667,0.0670391061452514
"563","7433","7190",2,1,1,8,32.5,20.25,0.0987654320987654
"564","7443","7355",1,1,0,18.1666666666667,31.6666666666667,24.9166666666667,0.040133779264214
"565","7448","",1,1,0,23.6666666666667,NA,NA,NA
"566","7448","6818",1,1,0,23.6666666666667,NA,NA,NA
"567","7448","7246",3,2,1,23.6666666666667,50.5,37.0833333333333,0.0808988764044944
"568","7448","7298",14,10,4,23.6666666666667,47.8333333333333,35.75,0.391608391608392
"569","7448","7324",4,3,1,23.6666666666667,48.8333333333333,36.25,0.110344827586207
"570","7448","7427",4,3,1,23.6666666666667,49.5,36.5833333333333,0.109339407744875
"571","7448","7453",2,2,0,23.6666666666667,34.3333333333333,29,0.0689655172413793
"572","7448","7461",4,2,2,23.6666666666667,29.6666666666667,26.6666666666667,0.15
"573","7450","7268",1,1,0,3.16666666666667,26.8333333333333,15,0.0666666666666667
"574","7450","7326",1,1,0,3.16666666666667,NA,NA,NA
"575","7450","7339",1,1,0,3.16666666666667,22.8333333333333,13,0.0769230769230769
"576","7452","7326",1,1,0,2.16666666666667,NA,NA,NA
"577","7452","7450",1,1,0,2.16666666666667,3.16666666666667,2.66666666666667,0.375
"578","7453","6818",2,2,0,34.3333333333333,NA,NA,NA
"579","7453","7072",1,1,0,34.3333333333333,29.5,31.9166666666667,0.031331592689295
"580","7453","7246",6,4,2,34.3333333333333,50.5,42.4166666666667,0.141453831041257
"581","7453","7298",10,3,7,34.3333333333333,47.8333333333333,41.0833333333333,0.243407707910751
"582","7453","7328",1,1,0,34.3333333333333,46.5,40.4166666666667,0.0247422680412371
"583","7453","7427",10,5,5,34.3333333333333,49.5,41.9166666666667,0.238568588469185
"584","7453","7448",5,4,1,34.3333333333333,23.6666666666667,29,0.172413793103448
"585","7453","7461",10,4,6,34.3333333333333,29.6666666666667,32,0.3125
"586","7455","7190",8,3,5,37.6666666666667,32.5,35.0833333333333,0.228028503562945
"587","7455","7270",4,2,2,37.6666666666667,30.3333333333333,34,0.117647058823529
"588","7455","7302",7,3,4,37.6666666666667,39,38.3333333333333,0.182608695652174
"589","7455","7345",8,1,7,37.6666666666667,30.5,34.0833333333333,0.234718826405868
"590","7455","7367",4,2,2,37.6666666666667,16,26.8333333333333,0.149068322981366
"591","7455","7407",10,6,4,37.6666666666667,31.3333333333333,34.5,0.289855072463768
"592","7456","7220",5,2,3,13.3333333333333,31.8333333333333,22.5833333333333,0.22140221402214
"593","7456","7227",2,1,1,13.3333333333333,18,15.6666666666667,0.127659574468085
"594","7456","7253",2,1,1,13.3333333333333,27.1666666666667,20.25,0.0987654320987654
"595","7456","7255",1,1,0,13.3333333333333,33.6666666666667,23.5,0.0425531914893617
"596","7456","7290",3,1,2,13.3333333333333,8.33333333333333,10.8333333333333,0.276923076923077
"597","7456","7291",1,1,0,13.3333333333333,26.5,19.9166666666667,0.0502092050209205
"598","7456","7315",2,1,1,13.3333333333333,28,20.6666666666667,0.0967741935483871
"599","7456","7345",1,1,0,13.3333333333333,30.5,21.9166666666667,0.0456273764258555
"600","7460","7010",7,3,4,22.3333333333333,44.5,33.4166666666667,0.209476309226933
"601","7460","7072",5,1,4,22.3333333333333,29.5,25.9166666666667,0.192926045016077
"602","7460","7225",1,1,0,22.3333333333333,6.16666666666667,14.25,0.0701754385964912
"603","7460","7267",6,1,5,22.3333333333333,35.5,28.9166666666667,0.207492795389049
"604","7460","7328",2,1,1,22.3333333333333,46.5,34.4166666666667,0.0581113801452785
"605","7460","7472",5,3,2,22.3333333333333,33,27.6666666666667,0.180722891566265
"606","7461","6818",2,2,0,29.6666666666667,NA,NA,NA
"607","7461","7246",11,3,8,29.6666666666667,50.5,40.0833333333333,0.274428274428274
"608","7461","7298",9,2,7,29.6666666666667,47.8333333333333,38.75,0.232258064516129
"609","7461","7324",7,3,4,29.6666666666667,48.8333333333333,39.25,0.178343949044586
"610","7461","7427",5,1,4,29.6666666666667,49.5,39.5833333333333,0.126315789473684
"611","7461","7448",8,3,5,29.6666666666667,23.6666666666667,26.6666666666667,0.3
"612","7461","7453",8,4,4,29.6666666666667,34.3333333333333,32,0.25
"613","7462","7234",9,5,4,13.1666666666667,28.3333333333333,20.75,0.433734939759036
"614","7462","7255",3,1,2,13.1666666666667,33.6666666666667,23.4166666666667,0.128113879003559
"615","7462","7265",1,1,0,13.1666666666667,16.1666666666667,14.6666666666667,0.0681818181818182
"616","7462","7391",4,2,2,13.1666666666667,25.8333333333333,19.5,0.205128205128205
"617","7472","7010",2,2,0,33,44.5,38.75,0.0516129032258065
"618","7472","7220",3,2,1,33,31.8333333333333,32.4166666666667,0.0925449871465296
"619","7472","7230",4,3,1,33,16.5,24.75,0.161616161616162
"620","7472","7267",2,1,1,33,35.5,34.25,0.0583941605839416
"621","7472","7291",4,3,1,33,26.5,29.75,0.134453781512605
"622","7472","7460",1,1,0,33,22.3333333333333,27.6666666666667,0.036144578313253
"623","7475","6937",6,2,4,27.1666666666667,20.3333333333333,23.75,0.252631578947368
"624","7475","7083",11,4,7,27.1666666666667,27.3333333333333,27.25,0.403669724770642
"625","7475","7233",1,1,0,27.1666666666667,27.1666666666667,27.1666666666667,0.0368098159509202
"626","7475","7234",1,1,0,27.1666666666667,28.3333333333333,27.75,0.036036036036036
"627","7475","7424",7,2,5,27.1666666666667,32.1666666666667,29.6666666666667,0.235955056179775
"628","7475","7425",3,1,2,27.1666666666667,4.66666666666667,15.9166666666667,0.18848167539267
"629","7475","7479",8,2,6,27.1666666666667,16,21.5833333333333,0.370656370656371
"630","7477","7065",1,1,0,4.66666666666667,1.5,3.08333333333333,0.324324324324324
"631","7477","7221",1,1,0,4.66666666666667,4.83333333333333,4.75,0.210526315789474
"632","7477","7291",1,1,0,4.66666666666667,26.5,15.5833333333333,0.0641711229946524
"633","7477","7342",1,1,0,4.66666666666667,28.5,16.5833333333333,0.0603015075376884
"634","7477","7472",1,1,0,4.66666666666667,33,18.8333333333333,0.0530973451327434
"635","7479","6937",5,2,3,16,20.3333333333333,18.1666666666667,0.275229357798165
"636","7479","7083",3,2,1,16,27.3333333333333,21.6666666666667,0.138461538461538
"637","7479","7424",3,2,1,16,32.1666666666667,24.0833333333333,0.124567474048443
"638","7479","7475",6,2,4,16,27.1666666666667,21.5833333333333,0.277992277992278
"639","7480","7040",11,5,6,42.6666666666667,39.5,41.0833333333333,0.267748478701826
"640","7480","7139",10,3,7,42.6666666666667,36.6666666666667,39.6666666666667,0.252100840336134
"641","7480","7386",7,2,5,42.6666666666667,41,41.8333333333333,0.167330677290837
"642","7480","7390",8,2,6,42.6666666666667,45,43.8333333333333,0.182509505703422
"643","7480","7410",14,3,11,42.6666666666667,41.6666666666667,42.1666666666667,0.33201581027668
"644","7480","7426",9,3,6,42.6666666666667,41.3333333333333,42,0.214285714285714
"645","7480","7485",5,1,4,42.6666666666667,20.8333333333333,31.75,0.15748031496063
"646","7482","6879",1,1,0,1.83333333333333,13,7.41666666666667,0.134831460674157
"647","7482","7221",3,2,1,1.83333333333333,4.83333333333333,3.33333333333333,0.9
"648","7485","7040",3,1,2,20.8333333333333,39.5,30.1666666666667,0.0994475138121547
"649","7485","7390",4,1,3,20.8333333333333,45,32.9166666666667,0.121518987341772
"650","7485","7480",3,1,2,20.8333333333333,42.6666666666667,31.75,0.094488188976378
"651","sun ","7286",1,1,0,NA,26.1666666666667,NA,NA
"652","6814","7186",1,0,1,12,29.3333333333333,20.6666666666667,0.0483870967741936
"653","6814","7456",1,0,1,12,13.3333333333333,12.6666666666667,0.0789473684210526
"654","6814","7462",6,0,6,12,13.1666666666667,12.5833333333333,0.47682119205298
"655","6833","7204",1,0,1,22.5,2.83333333333333,12.6666666666667,0.0789473684210526
"656","6833","7279",2,0,2,22.5,53.6666666666667,38.0833333333333,0.0525164113785558
"657","6879","6888",4,0,4,13,11.5,12.25,0.326530612244898
"658","6879","7278",1,0,1,13,15,14,0.0714285714285714
"659","6879","7355",1,0,1,13,31.6666666666667,22.3333333333333,0.0447761194029851
"660","6879","7366",1,0,1,13,7.5,10.25,0.0975609756097561
"661","6888","7038",1,0,1,11.5,26.8333333333333,19.1666666666667,0.0521739130434783
"662","6888","7040",1,0,1,11.5,39.5,25.5,0.0392156862745098
"663","6888","7236",1,0,1,11.5,23.5,17.5,0.0571428571428571
"664","6888","7278",1,0,1,11.5,15,13.25,0.0754716981132075
"665","6888","7369",1,0,1,11.5,23.6666666666667,17.5833333333333,0.0568720379146919
"666","6937","7424",1,0,1,20.3333333333333,32.1666666666667,26.25,0.0380952380952381
"667","6937","7425",1,0,1,20.3333333333333,4.66666666666667,12.5,0.08
"668","6937","7475",2,0,2,20.3333333333333,27.1666666666667,23.75,0.0842105263157895
"669","7038","7236",4,0,4,26.8333333333333,23.5,25.1666666666667,0.158940397350993
"670","7040","7222",1,0,1,39.5,16.5,28,0.0357142857142857
"671","7040","7276",1,0,1,39.5,23.6666666666667,31.5833333333333,0.0316622691292876
"672","7072","7265",1,0,1,29.5,16.1666666666667,22.8333333333333,0.0437956204379562
"673","7083","7268",1,0,1,27.3333333333333,26.8333333333333,27.0833333333333,0.0369230769230769
"674","7083","7295",1,0,1,27.3333333333333,29.8333333333333,28.5833333333333,0.0349854227405248
"675","7083","7425",1,0,1,27.3333333333333,4.66666666666667,16,0.0625
"676","7083","7479",5,0,5,27.3333333333333,16,21.6666666666667,0.230769230769231
"677","7083","7485",1,0,1,27.3333333333333,20.8333333333333,24.0833333333333,0.041522491349481
"678","7139","7222",1,0,1,36.6666666666667,16.5,26.5833333333333,0.0376175548589342
"679","7139","7426",2,0,2,36.6666666666667,41.3333333333333,39,0.0512820512820513
"680","7139","7479",1,0,1,36.6666666666667,16,26.3333333333333,0.0379746835443038
"681","7186","7225",2,0,2,29.3333333333333,6.16666666666667,17.75,0.112676056338028
"682","7186","7291",1,0,1,29.3333333333333,26.5,27.9166666666667,0.0358208955223881
"683","7186","7315",1,0,1,29.3333333333333,28,28.6666666666667,0.0348837209302326
"684","7186","7355",3,0,3,29.3333333333333,31.6666666666667,30.5,0.0983606557377049
"685","7186","7380",1,0,1,29.3333333333333,27.8333333333333,28.5833333333333,0.0349854227405248
"686","7190","7268",1,0,1,32.5,26.8333333333333,29.6666666666667,0.0337078651685393
"687","7194","7475",1,0,1,38,27.1666666666667,32.5833333333333,0.030690537084399
"688","7197","7065",1,0,1,0.833333333333333,1.5,1.16666666666667,0.857142857142857
"689","7204","7232",1,0,1,2.83333333333333,25.6666666666667,14.25,0.0701754385964912
"690","7207","7265",1,0,1,45.6666666666667,16.1666666666667,30.9166666666667,0.032345013477089
"691","7207","7462",1,0,1,45.6666666666667,13.1666666666667,29.4166666666667,0.0339943342776204
"692","7214","7055",1,0,1,1.66666666666667,2.16666666666667,1.91666666666667,0.521739130434783
"693","7219","7342",1,0,1,38.3333333333333,28.5,33.4166666666667,0.0299251870324189
"694","7220","7207",1,0,1,31.8333333333333,45.6666666666667,38.75,0.0258064516129032
"695","7220","7222",1,0,1,31.8333333333333,16.5,24.1666666666667,0.0413793103448276
"696","7220","7227",2,0,2,31.8333333333333,18,24.9166666666667,0.0802675585284281
"697","7220","7384",2,0,2,31.8333333333333,11.5,21.6666666666667,0.0923076923076923
"698","7221","6833",1,0,1,4.83333333333333,22.5,13.6666666666667,0.0731707317073171
"699","7221","7232",1,0,1,4.83333333333333,25.6666666666667,15.25,0.0655737704918033
"700","7222","7342",1,0,1,16.5,28.5,22.5,0.0444444444444444
"701","7225","7227",3,0,3,6.16666666666667,18,12.0833333333333,0.248275862068966
"702","7225","7355",1,0,1,6.16666666666667,31.6666666666667,18.9166666666667,0.052863436123348
"703","7225","7460",1,0,1,6.16666666666667,22.3333333333333,14.25,0.0701754385964912
"704","7227","7225",3,0,3,18,6.16666666666667,12.0833333333333,0.248275862068966
"705","7227","7355",1,0,1,18,31.6666666666667,24.8333333333333,0.0402684563758389
"706","7227","7472",1,0,1,18,33,25.5,0.0392156862745098
"707","7230","7265",1,0,1,16.5,16.1666666666667,16.3333333333333,0.0612244897959184
"708","7233","6888",1,0,1,27.1666666666667,11.5,19.3333333333333,0.0517241379310345
"709","7233","7280",1,0,1,27.1666666666667,15.3333333333333,21.25,0.0470588235294118
"710","7234","6905",1,0,1,28.3333333333333,1.16666666666667,14.75,0.0677966101694915
"711","7234","7290",2,0,2,28.3333333333333,8.33333333333333,18.3333333333333,0.109090909090909
"712","7246","7342",1,0,1,50.5,28.5,39.5,0.0253164556962025
"713","7246","7453",7,0,7,50.5,34.3333333333333,42.4166666666667,0.165029469548134
"714","7253","7225",1,0,1,27.1666666666667,6.16666666666667,16.6666666666667,0.06
"715","7253","7232",1,0,1,27.1666666666667,25.6666666666667,26.4166666666667,0.0378548895899054
"716","7253","7276",1,0,1,27.1666666666667,23.6666666666667,25.4166666666667,0.039344262295082
"717","7253","7290",1,0,1,27.1666666666667,8.33333333333333,17.75,0.0563380281690141
"718","7255","7222",1,0,1,33.6666666666667,16.5,25.0833333333333,0.0398671096345515
"719","7255","7253",1,0,1,33.6666666666667,27.1666666666667,30.4166666666667,0.0328767123287671
"720","7263","7276",1,0,1,50.8333333333333,23.6666666666667,37.25,0.0268456375838926
"721","7263","7324",1,0,1,50.8333333333333,48.8333333333333,49.8333333333333,0.020066889632107
"722","7263","7328",1,0,1,50.8333333333333,46.5,48.6666666666667,0.0205479452054795
"723","7263","7453",1,0,1,50.8333333333333,34.3333333333333,42.5833333333333,0.0234833659491194
"724","7265","7267",1,0,1,16.1666666666667,35.5,25.8333333333333,0.0387096774193548
"725","7267","7460",7,0,7,35.5,22.3333333333333,28.9166666666667,0.242074927953891
"726","7268","7236",1,0,1,26.8333333333333,23.5,25.1666666666667,0.0397350993377483
"727","7268","7271",1,0,1,26.8333333333333,17,21.9166666666667,0.0456273764258555
"728","7268","7334",1,0,1,26.8333333333333,28,27.4166666666667,0.0364741641337386
"729","7268","7480",1,0,1,26.8333333333333,42.6666666666667,34.75,0.0287769784172662
"730","7270","7040",1,0,1,30.3333333333333,39.5,34.9166666666667,0.0286396181384248
"731","7270","7190",1,0,1,30.3333333333333,32.5,31.4166666666667,0.0318302387267905
"732","7270","7302",1,0,1,30.3333333333333,39,34.6666666666667,0.0288461538461538
"733","7270","7367",2,0,2,30.3333333333333,16,23.1666666666667,0.0863309352517986
"734","7270","7480",1,0,1,30.3333333333333,42.6666666666667,36.5,0.0273972602739726
"735","7271","7278",1,0,1,17,15,16,0.0625
"736","7276","7342",1,0,1,23.6666666666667,28.5,26.0833333333333,0.0383386581469649
"737","7276","7380",2,0,2,23.6666666666667,27.8333333333333,25.75,0.0776699029126214
"738","7276","7480",1,0,1,23.6666666666667,42.6666666666667,33.1666666666667,0.0301507537688442
"739","7278","7276",1,0,1,15,23.6666666666667,19.3333333333333,0.0517241379310345
"740","7278","7314",8,0,8,15,11.6666666666667,13.3333333333333,0.6
"741","7279","6833",1,0,1,53.6666666666667,22.5,38.0833333333333,0.0262582056892779
"742","7279","7265",1,0,1,53.6666666666667,16.1666666666667,34.9166666666667,0.0286396181384248
"743","7279","7328",1,0,1,53.6666666666667,46.5,50.0833333333333,0.0199667221297837
"744","7279","7342",1,0,1,53.6666666666667,28.5,41.0833333333333,0.0243407707910751
"745","7279","7480",1,0,1,53.6666666666667,42.6666666666667,48.1666666666667,0.0207612456747405
"746","7286","7280",1,0,1,26.1666666666667,15.3333333333333,20.75,0.0481927710843374
"747","7291","7384",4,0,4,26.5,11.5,19,0.210526315789474
"748","7295","7233",4,0,4,29.8333333333333,27.1666666666667,28.5,0.140350877192982
"749","7302","7367",3,0,3,39,16,27.5,0.109090909090909
"750","7302","7433",1,0,1,39,8,23.5,0.0425531914893617
"751","7313","7346",1,0,1,30.1666666666667,26.8333333333333,28.5,0.0350877192982456
"752","7314","6879",4,0,4,11.6666666666667,13,12.3333333333333,0.324324324324324
"753","7315","7207",1,0,1,28,45.6666666666667,36.8333333333333,0.0271493212669683
"754","7315","7220",2,0,2,28,31.8333333333333,29.9166666666667,0.0668523676880223
"755","7315","7263",1,0,1,28,50.8333333333333,39.4166666666667,0.0253699788583509
"756","7315","7384",1,0,1,28,11.5,19.75,0.0506329113924051
"757","7315","7443",1,0,1,28,18.1666666666667,23.0833333333333,0.0433212996389892
"758","7315","7456",1,0,1,28,13.3333333333333,20.6666666666667,0.0483870967741935
"759","7323","7324",2,0,2,6.5,48.8333333333333,27.6666666666667,0.072289156626506
"760","7324","7448",2,0,2,48.8333333333333,23.6666666666667,36.25,0.0551724137931034
"761","7324","7453",5,0,5,48.8333333333333,34.3333333333333,41.5833333333333,0.120240480961924
"762","7328","7315",1,0,1,46.5,28,37.25,0.0268456375838926
"763","7328","7427",2,0,2,46.5,49.5,48,0.0416666666666667
"764","7328","7460",3,0,3,46.5,22.3333333333333,34.4166666666667,0.0871670702179177
"765","7334","7452",1,0,1,28,2.16666666666667,15.0833333333333,0.0662983425414365
"766","7339","7274",4,0,4,22.8333333333333,13.5,18.1666666666667,0.220183486238532
"767","7340","7233",1,0,1,11,27.1666666666667,19.0833333333333,0.0524017467248908
"768","7340","7314",1,0,1,11,11.6666666666667,11.3333333333333,0.0882352941176471
"769","7340","7328",1,0,1,11,46.5,28.75,0.0347826086956522
"770","7342","7186",1,0,1,28.5,29.3333333333333,28.9166666666667,0.0345821325648415
"771","7342","7355",1,0,1,28.5,31.6666666666667,30.0833333333333,0.0332409972299169
"772","7345","7367",1,0,1,30.5,16,23.25,0.043010752688172
"773","7345","7460",1,0,1,30.5,22.3333333333333,26.4166666666667,0.0378548895899054
"774","7346","7268",1,0,1,26.8333333333333,26.8333333333333,26.8333333333333,0.0372670807453416
"775","7346","7334",1,0,1,26.8333333333333,28,27.4166666666667,0.0364741641337386
"776","7352","7190",1,0,1,8.66666666666667,32.5,20.5833333333333,0.048582995951417
"777","7352","7345",2,0,2,8.66666666666667,30.5,19.5833333333333,0.102127659574468
"778","7352","7460",1,0,1,8.66666666666667,22.3333333333333,15.5,0.0645161290322581
"779","7355","7225",1,0,1,31.6666666666667,6.16666666666667,18.9166666666667,0.052863436123348
"780","7355","7475",1,0,1,31.6666666666667,27.1666666666667,29.4166666666667,0.0339943342776204
"781","7363","7381",1,0,1,5.33333333333333,3.66666666666667,4.5,0.222222222222222
"782","7366","7038",1,0,1,7.5,26.8333333333333,17.1666666666667,0.058252427184466
"783","7366","7314",3,0,3,7.5,11.6666666666667,9.58333333333333,0.31304347826087
"784","7367","6879",1,0,1,16,13,14.5,0.0689655172413793
"785","7367","7270",2,0,2,16,30.3333333333333,23.1666666666667,0.0863309352517986
"786","7367","7424",1,0,1,16,32.1666666666667,24.0833333333333,0.041522491349481
"787","7369","7038",2,0,2,23.6666666666667,26.8333333333333,25.25,0.0792079207920792
"788","7369","7280",1,0,1,23.6666666666667,15.3333333333333,19.5,0.0512820512820513
"789","7369","7314",1,0,1,23.6666666666667,11.6666666666667,17.6666666666667,0.0566037735849057
"790","7369","7450",1,0,1,23.6666666666667,3.16666666666667,13.4166666666667,0.0745341614906832
"791","7380","7186",1,0,1,27.8333333333333,29.3333333333333,28.5833333333333,0.0349854227405248
"792","7380","7220",2,0,2,27.8333333333333,31.8333333333333,29.8333333333333,0.0670391061452514
"793","7380","7298",1,0,1,27.8333333333333,47.8333333333333,37.8333333333333,0.026431718061674
"794","7380","7443",1,0,1,27.8333333333333,18.1666666666667,23,0.0434782608695652
"795","7384","7186",1,0,1,11.5,29.3333333333333,20.4166666666667,0.0489795918367347
"796","7384","7246",1,0,1,11.5,50.5,31,0.032258064516129
"797","7390","7253",1,0,1,45,27.1666666666667,36.0833333333333,0.0277136258660508
"798","7390","7291",1,0,1,45,26.5,35.75,0.027972027972028
"799","7390","7427",1,0,1,45,49.5,47.25,0.0211640211640212
"800","7407","7040",1,0,1,31.3333333333333,39.5,35.4166666666667,0.0282352941176471
"801","7407","7410",1,0,1,31.3333333333333,41.6666666666667,36.5,0.0273972602739726
"802","7407","7433",1,0,1,31.3333333333333,8,19.6666666666667,0.0508474576271186
"803","7410","7222",1,0,1,41.6666666666667,16.5,29.0833333333333,0.0343839541547278
"804","7424","7367",1,0,1,32.1666666666667,16,24.0833333333333,0.041522491349481
"805","7425","6937",1,0,1,4.66666666666667,20.3333333333333,12.5,0.08
"806","7426","7139",4,0,4,41.3333333333333,36.6666666666667,39,0.102564102564103
"807","7426","7314",1,0,1,41.3333333333333,11.6666666666667,26.5,0.0377358490566038
"808","7426","7427",1,0,1,41.3333333333333,49.5,45.4166666666667,0.0220183486238532
"809","7427","7315",1,0,1,49.5,28,38.75,0.0258064516129032
"810","7430","7083",1,0,1,2.66666666666667,27.3333333333333,15,0.0666666666666667
"811","7433","7455",1,0,1,8,37.6666666666667,22.8333333333333,0.0437956204379562
"812","7443","7218",2,0,2,18.1666666666667,28.6666666666667,23.4166666666667,0.0854092526690391
"813","7443","7220",1,0,1,18.1666666666667,31.8333333333333,25,0.04
"814","7443","7232",1,0,1,18.1666666666667,25.6666666666667,21.9166666666667,0.0456273764258555
"815","7443","7263",1,0,1,18.1666666666667,50.8333333333333,34.5,0.0289855072463768
"816","7443","7276",1,0,1,18.1666666666667,23.6666666666667,20.9166666666667,0.047808764940239
"817","7443","7291",1,0,1,18.1666666666667,26.5,22.3333333333333,0.0447761194029851
"818","7443","7315",1,0,1,18.1666666666667,28,23.0833333333333,0.0433212996389892
"819","7443","7342",1,0,1,18.1666666666667,28.5,23.3333333333333,0.0428571428571429
"820","7443","7380",1,0,1,18.1666666666667,27.8333333333333,23,0.0434782608695652
"821","7448","7328",1,0,1,23.6666666666667,46.5,35.0833333333333,0.0285035629453682
"822","7450","7280",1,0,1,3.16666666666667,15.3333333333333,9.25,0.108108108108108
"823","7453","7324",3,0,3,34.3333333333333,48.8333333333333,41.5833333333333,0.0721442885771543
"824","7455","7230",1,0,1,37.6666666666667,16.5,27.0833333333333,0.0369230769230769
"825","7455","7352",4,0,4,37.6666666666667,8.66666666666667,23.1666666666667,0.172661870503597
"826","7455","7386",1,0,1,37.6666666666667,41,39.3333333333333,0.0254237288135593
"827","7455","7433",3,0,3,37.6666666666667,8,22.8333333333333,0.131386861313869
"828","7456","7186",1,0,1,13.3333333333333,29.3333333333333,21.3333333333333,0.046875
"829","7456","7225",2,0,2,13.3333333333333,6.16666666666667,9.75,0.205128205128205
"830","7460","7207",6,0,6,22.3333333333333,45.6666666666667,34,0.176470588235294
"831","7460","7220",1,0,1,22.3333333333333,31.8333333333333,27.0833333333333,0.0369230769230769
"832","7460","7265",1,0,1,22.3333333333333,16.1666666666667,19.25,0.051948051948052
"833","7460","7407",1,0,1,22.3333333333333,31.3333333333333,26.8333333333333,0.0372670807453416
"834","7461","7367",1,0,1,29.6666666666667,16,22.8333333333333,0.0437956204379562
"835","7462","6814",2,0,2,13.1666666666667,12,12.5833333333333,0.158940397350993
"836","7462","6905",1,0,1,13.1666666666667,1.16666666666667,7.16666666666667,0.13953488372093
"837","7462","7010",1,0,1,13.1666666666667,44.5,28.8333333333333,0.0346820809248555
"838","7462","7072",1,0,1,13.1666666666667,29.5,21.3333333333333,0.046875
"839","7462","7186",1,0,1,13.1666666666667,29.3333333333333,21.25,0.0470588235294118
"840","7472","7072",1,0,1,33,29.5,31.25,0.032
"841","7472","7222",2,0,2,33,16.5,24.75,0.0808080808080808
"842","7472","7253",2,0,2,33,27.1666666666667,30.0833333333333,0.0664819944598338
"843","7472","7255",1,0,1,33,33.6666666666667,33.3333333333333,0.03
"844","7475","7194",1,0,1,27.1666666666667,38,32.5833333333333,0.030690537084399
"845","7475","7286",1,0,1,27.1666666666667,26.1666666666667,26.6666666666667,0.0375
"846","7475","7367",1,0,1,27.1666666666667,16,21.5833333333333,0.0463320463320463
"847","7477","7452",1,0,1,4.66666666666667,2.16666666666667,3.41666666666667,0.292682926829268
"848","7479","7425",1,0,1,16,4.66666666666667,10.3333333333333,0.0967741935483871
"849","7480","7302",1,0,1,42.6666666666667,39,40.8333333333333,0.0244897959183673
"850","7480","7345",1,0,1,42.6666666666667,30.5,36.5833333333333,0.0273348519362187
"851","7485","7139",4,0,4,20.8333333333333,36.6666666666667,28.75,0.139130434782609
"852","7485","7386",3,0,3,20.8333333333333,41,30.9166666666667,0.0970350404312669
"853","7485","7410",2,0,2,20.8333333333333,41.6666666666667,31.25,0.064
"854","7485","7426",3,0,3,20.8333333333333,41.3333333333333,31.0833333333333,0.096514745308311
